アパット = Apartment
えき = Station
えんぴつ = pencil
かばん = bag/luggage
カフェ = cafe
きっさてん = café (Traditional)
きょうかしょ = textbook
ぎんこう = bank
けしゴム = eraser
こうえん = park
こうばん = police box
このへん = this area
コンビニ = convenience store
じしょ = dictionary
スーパー = supermarket
たてもの = building/structure
テスト = test
デパート = department store
ノート = notebook
ビル = building
びょういん = hospital
ペン = pen
ボールペン = ballpoint pen
ほんや = bookstore
まち = town
ゆうびんきょく = post office
りょう = dormitory
レストラン = restaurant
います = to be/exist
あそこ = over there
あれ = that, (not near the speaker or listener)
ここ = here
これ = this
そこ = there that place
それ = that

